GOR = "countries/Greater Austria.txt"
GRM = "countries/German Empire.txt"
CRN = "countries/Carniola.txt"
CRA = "countries/Croatia.txt"
TRA = "countries/Translyvania.txt"
HUG = "countries/Hungary.txt"
WGA = "countries/West Galicia.txt"
VOJ = "countries/Vojvodina.txt"
SEB = "countries/Serbia.txt"
BOH = "countries/Bohemia.txt"
EGA = "countries/East Galicia.txt"
BON = "countries/Bosnia.txt"
#ITA = "countries/Italy.txt"
#SOV = "countries/Soviet Union.txt"
#asia
ANH = "countries/Anhui.txt"
BEI = "countries/Beiyang.txt"
CHF = "countries/ChinaFederation.txt"
CTI = "countries/Yihetuan.txt"
ETR = "countries/East Turkestan.txt"
FJN = "countries/Fujian.txt"
GNG = "countries/Guangdong.txt"
HEN = "countries/Henan.txt"
HBI = "countries/Hubei.txt"
HNN = "countries/Hunan.txt"
JGX = "countries/Jiangxi.txt"
SHD = "countries/Shandong.txt"
SZE = "countries/Sichuan.txt"
TAI = "countries/Taiwan.txt"
XSG = "countries/Gansu Ma Clique.txt"
ZHI = "countries/Zhili.txt"
ZHJ = "countries/Zhejiang.txt"
BLU = "countries/Bolshevik Union.txt"